#####################################
#               #                   #
#               #                   #
#               #                   #
#               #                   #
#                                   #
#               #                   #
#######  #################  #########
#           #                       #
#           #                       #
#           #           G           #
#           #                       #
#                                   #
#           #                       #
#####################################