#####################################
#111111111111111#3333333333333333333#
#111111111111111#3333333333333333333#
#111111111111111#3333333333333333333#
#111111111111111#3333333333333333333#
#111111111111111 3333333333333333333#
#111111111111111#3333333333333333333#
####### ##################G##########
#22222222222#44444444444444444444444#
#22222222222#44444444444444444444444#
#22222222222#44444444444444444444444#
#22222222222#44444444444444444444444#
#22222222222 44444444444444444444444#
#22222222222#44444444444444444444444#
#####################################